+-------------------+
|                   |
|   box2            |
|                   |
|          box1     |
|                   |
| box3              |
|                   |
+-------------------+
